++++++++++++++++++++++++++++++
{----------------------------}
$............................/
$..........................#№/
$..........................!&/
$..........................!&/
$.....|:"""""""""""""""""""""/
$.....|....................../
$.....|....................../
$.....|....................../
$.....|.........|:""""""""";./
$.....|.........|............/
$.....|.........|............/
$.....|.........|............/
$..:""""""""""";|............/
$...............|............/
$...............|............/
$...............|............/
$......|:""""""""""";......../
$......|...................../
$......|...................../
$......|...................../
[____________________________]
++++++++++++++++++++++++++++++