++++++++++++++++++++++++++++++
{----------------------------}
$............................/
$#№........................../
$!&........................../
$!&......................|.../
$:"""""""""""""""""""""";|.../
$........................|.../
$........................|.../
$...........|............|.../
$...........|:"""""""""""""";/
$...........|................/
$...........|................/
$...........|..............|./
$:""""""""";|........:"""";|./
$...........|..............|./
$...........|..............|./
$...........|........|.....|./
$.........:"""""""";.|:""""";/
$....................|......./
$...P................|......./
$....................|......./
[____________________________]
++++++++++++++++++++++++++++++