++++++++++++++++++++++++++++++
{----------------------------}
$............................/
$............................/
$............................/
$............................/
$............................/
$............................/
$............................/
$............................/
$............................/
$............................/
$............................/
$............................/
$............................/
$............................/
$............................/
$............................/
$............................/
$............................/
$............................/
$............................/
[____________________________]
++++++++++++++++++++++++++++++