++++++++++++++++++++++++++++++
{----------------------------}
$............................/
$#№........................../
$!&........................../
$!&......................|.../
$:""""""""""""""""""""";.|.../
$........................|.../
$........................|.../
$..........|.............|.../
$..........|.:"""""""""""""""/
$..........|................./
$..........|................./
$..........|...........^^..|./
$:""""""";.|..........:"";.|./
$..........|...............|./
$..........|...............|./
$..........|........|......|./
$........:"""""""";.|.:""""""/
$...................|......../
$...P...............|......../
$...................|......../
[____________________________]
++++++++++++++++++++++++++++++