++++++++++++++++++++++++++++++
{----------------------------}
$............................/
$#№........................../
$!&........................../
$!&........................../
$:"""""""""""""""""""""";|.../
$........................|.../
$........................|.../
$........................|.../
$...........|:"""""""""""""";/
$...........|................/
$...........|................/
$...........|................/
$:""""""""";|........:"""";|./
$...........|..............|./
$...........|..............|./
$...........|..............|./
$.........:""""""""";|:""""";/
$....................|......./
$....................|......./
$....................|......./
[____________________________]
++++++++++++++++++++++++++++++