++++++++++++++++++++++++++++++
{----------------------------}
$............................/
$............................/
$:"""""""""""""""""""""";|.../
$........................|.../
$........................|.../
$...........|:"""""""""""""";/
$...........|................/
$:""""""""";|................/
$...........|........:"""";|./
$...........|..............|./
$...........|..............|./
$.........:""""""""";|:""""";/
$....................|......./
$....................|......./
$....................|......./
[____________________________]
++++++++++++++++++++++++++++++