+++++++++++++++
{-------------}
$............./
$............./
$...|........./
$...|........./
$...|........./
[_____________]
+++++++++++++++