++++++++++++++++++++++++++++++
{----------------------------}
$............................/
$#№........................../
$!&..........M.............../
$!&...................|....../
$""""""""""""""""""";.|....../
$.....................|....../
$.....................|....../
$.....................|....../
$.....................|....../
$.^....|.......^......|....../
$"""";.|.:"""""""""";.|....../
$......|..............|....../
$......|..............|....../
$......|..............|....../
$"""";.|..............|....../
$......|..............|.:""""/
$......|..............|....../
$......|..............|....../
$..P...|..............|....../
$......|.....*........|....../
[____________________________]
++++++++++++++++++++++++++++++