++++++++++++++++++++++++++++++
{----------------------------}
$............................/
$............................/
$....................^^^^^^^./
$..|..|.!&.|...!&.|..^^^^^^^./
$..|..|.!&.|...!&.|..:""""";./
$..|..|.!&.|...!&.|....!&..../
$..|..|.!&.|...!&.|....!&..../
$..|.!&..|..|..!&.|....!&..../
$..|.!&..|..|..!&.|....!&..../
$..|.!&..|..|.....|....|...../
$..|.!&|........|...|..|...../
$..|.!&|........|...|..|...../
$..|.!&|........|.|.|..|...../
$..|!&!&......!&|...|..|...../
$..|!&!&......!&|.|.!&.|...../
$..|!&!&......!&|...!&......./
$..|!&!&......!&|...!&......./
$..|!&!&......!&!&..!&......./
$.P|!&!&......!&!&..!&......./
$..|!&!&......!&!&..!&......./
[____________________________]
++++++++++++++++++++++++++++++